MarkPerfTestTime 100	// InterpretScript: begin
MarkPerfTestTime 105	// InterpretScript: Init1
MarkPerfTestTime 110	// InterpretScript: Init2
MarkPerfTestTime 111	// InterpretScript: ExtractLinesIntoIO
MarkPerfTestTime 112	// InterpretScript: ExtractLinesIntoVal
MarkPerfTestTime 113	// InterpretScript: ExtractValSetEle
MarkPerfTestTime 114	// InterpretScript: AdjustInter..
MarkPerfTestTime 115	// InterpretScript: ExpandFramesIncDec
MarkPerfTestTime 116	// InterpretScript: ExpandSweepsWithPoverN
MarkPerfTestTime 117	// InterpretScript: ComputeTotalPoints
MarkPerfTestTime 118	// InterpretScript: ProcessDigitalOutputs
MarkPerfTestTime 119	// InterpretScript: OutElemsAllToWaves
MarkPerfTestTime 120	// InterpretScript: SupplyCOMPChans
MarkPerfTestTime 121	// InterpretScript: DisplayStimulus
MarkPerfTestTime 122	// InterpretScript: CEDInititialize

MarkPerfTestTime 202	// ExtractLinesIntoVal: mI
MarkPerfTestTime 203	// ExtractLinesIntoVal: ExtractValue

MarkPerfTestTime 304	// ExtractValue: sPulsLine=RemoveListItem
MarkPerfTestTime 306	// ExtractValue: Loop Frames vS
MarkPerfTestTime 310	// ExtractValue: Init
MarkPerfTestTime 312	// ExtractValue: end

MarkPerfTestTime 400	// ExtractValue Loop Frames: Begin
MarkPerfTestTime 402	// ExtractValue Loop Frames: vS

MarkPerfTestTime 500	// ExtractValue Loop Keys : Begin
MarkPerfTestTime 510	// ExtractValue Loop Keys : Init
MarkPerfTestTime 520	// ExtractValue Loop Keys : Loop Frames

MarkPerfTestTime 600	// CEDInititialize: Begin
MarkPerfTestTime 610	// CEDInititialize: Init
MarkPerfTestTime 612	// CEDInititialize: Start Loop chunks
MarkPerfTestTime 614	// CEDInititialize: ConvolveDA
MarkPerfTestTime 615	// CEDInititialize: GetErrors TO1401
MarkPerfTestTime 616	// CEDInititialize: GetErrors SS2
MarkPerfTestTime 617	// CEDInititialize: SendString SM2 Dac
MarkPerfTestTime 618	// CEDInititialize: GetErrors SM2 Dac
MarkPerfTestTime 620	// CEDInititialize: Init

MarkPerfTestTime 710	// InterpretScript: DisplayStimulus Step1 end
MarkPerfTestTime 712	// InterpretScript: DisplayStimulus Step2 make1
MarkPerfTestTime 713	// InterpretScript: DisplayStimulus Step2 bDacOn
MarkPerfTestTime 714	// InterpretScript: DisplayStimulus Step2 make CntDa
MarkPerfTestTime 716	// InterpretScript: DisplayStimulus Step2 make CntDGO
MarkPerfTestTime 720	// InterpretScript: DisplayStimulus Step2 end
MarkPerfTestTime 730	// InterpretScript: DisplayStimulus Step3 end
MarkPerfTestTime 740	// InterpretScript: DisplayStimulus Step4 end

MarkPerfTestTime 810	// InterpretScript: DisplayStimul_1 Step1 end
MarkPerfTestTime 820	// InterpretScript: DisplayStimul_1 Step2 start
MarkPerfTestTime 822	// InterpretScript: DisplayStimul_1 Step3 fill points
MarkPerfTestTime 824	// InterpretScript: DisplayStimul_1 Step3 wavestats
MarkPerfTestTime 830	// InterpretScript: DisplayStimul_1 Step3 end
MarkPerfTestTime 840	// InterpretScript: DisplayStimul_1 Step4 end
